################################
...........................P....
################################
...............#.###............
...............#...#............
..............######............
...............#................
................................
................................
................................
................................
................................
................................
................................
................................
................................
................................
................................
................................
................................
................................
................................
................................
................................